############
#......#pg.#
##.....#p..#
##....##...#
#..pp...W..#
#........###
#..........#
#....###...#
#....ppp...#
###...#....#
#H....#....#
############